0
XXXXXXXXXXXXXXXXXXXXXXXXXXXXXXXXXXX
XXXXX                    XX      XX
XXXXX  XXXXXXXXXXXXX XXX XX      XX
XXXXX  XXX         X     XX  XX  XX
XXXXX  XXX XXXXXX  XXXXXXXX  XX   X
X               X  XX     X  XXXXXX
X   XXXX   XXX  X  XX  X  X  XX   X
XXX     XX XXX  X  XXXXX  X  XX X X
XXX X X                   X  XXXX X
XXX X X XXXXXXXXX  XXXXX  X  XXXX X
XXX XXX            XXXX           X
XXX   X XXXXXXXXXXXXXXX XXXXXXXXXXX
      X XXXX        XXX XX     S  X
XXXXXXX XXXX XXXXXXXXXX XX XXXXXXXX
XXX                XXXX XX X  X   X
XXXXXXXXX  XXXXX   XX      X XX XXX
XXX    XX          XX XXXX      XXX
XXX XX XX   XXXXXX XX XXXX XXXX XXX
XXX XX                            X
XXXXXXXXXXXXXXXXXXXXXXXXXXXXXXXXXXX